
[START]

bar association - ассоциация юристов
bar exam - экзамен на юриста
lay out - изложить, обьяснить
to embrace - принимать какуюто идею 

stands erect - стоять прямо

whats new ?
steer clear of the word - тебе лучше держаться подалее от слова
dump it - выбрось это
give me for instance - например
what have you been up to - что ты делал все это время
tan - загар
what are we supposed to be seeing here ? - что мы должны тут увидеть ?
cheap shot - грубость
weak - слабый
convenience - удобство
inconvenience - неудобство
yardstick - эталон
	lets take this function as a yardstick againts which all future functions will be measured
innate - врожденный
	this dog has innate crooked nose which makes her to snore almost all the time, even when not sleeping
tinfoil hat - шапка из фольги
we are even - мы в расчете
	I'll by you a beer and we are even
unfair - несправедливый
fair - справедливо
flaw - неостаток
	this dog has a innate flaw with her crooked nose, it snoring all the time almost
	
endear - вызывать симпатию
endearing - мило
bottom line - итог	
внезапно - suddenly
break up - расставаться
no easy way to do this
no easy way to do this we will have to create all this files one by one
paw - лапа
lick - облизывать
bend - сгибаться
	one of the cats is big and I think it so lazy to bend for drinking a water that she put her paw into water and then lick it 
relieve - облегчение
stand someone - выдержать когото
	I cant stand your friends - не могу вытерпеть твоих друзей
rain forest - тропический лес
elbow - локоть
slumber party - девичник
tweezer - пинцет
what this is reference to - о чем это
give up - сдаться
give up from - отказаться
flupie - When life is completely chaotic and you have no idea of the path you are on.
who is he sleeping - с кем он переспал
courage - храбрость
handed - передать, вручить
awkward - неловкий
gang up - вступить в шайку, сговориться
eager - нетерпеливый
accents my hobby - подчеркивает мое хобби
upsetting me - расстраивает меня
	it starts being darkness early at evenings and this is upsetting me
	
apparently - видимо
fluffy - пушистый
sophisticated - утонченный
belch - отрыжка
tall - высокий
short - короткий
blew off the rest - плюнуть на все остальное
tough - жесткий
that would be a judgment call - это юридически сложный вопрос
terrific - потрясающий
its like a pulling off a band-aid - это как оторвать пластырь
the wound is exposed - рана откроется
go out - выходить
disgusting - отвратительно
its like a gift - это вроде дара
rip - рвать
grieve - скорбить
violate - насиловать
passion - страсть
but just beraly - но еще чуть чуть
greet - приветствовать
bead - шарик
inching - медленно
resent - возмущатся
feel obligated to her - чувствовать себя обязанным преед ней
he runs the pipeline - он управляет пайплайном
lit - зажечь, осветить





like that thought never entered my mind - типо я не думал никогда об этом
senior year - выпускной год
il always the last one to know everyting - я всегда узнаю все последним
you betcha - еще бы, и не сомневайся
thats not where I was going - это не то к чему я клоню
crap-weasel - 
spooky - жутко
I have to bring it up - мне нужно это поднять
to go out with her - пйоти с ней на свидание
you were seeing Ben - ты встречался с беном
vague - нечеткий
we are gonna be here for a while it looks like
apparently - видимо
i'm totally behind this experiment - я только за этот эксперимент
chip in - вмешаться, внести свой вклад, скинуться
vividly - ярко
merriment - веселье
potato pancakes - драники
filling - начинка
garnish - гарнир
whipped - взбитый
fall over the park - упасть над парком
wont make me go any faster - не заставит меня идти быстрее
pick a major - выбрать специльаность
on a dare - на спор
vomiting - рвота
demand - требовать
bewitchen - околдовывать
how I supposed to know - как я должен был знать
smidge - капелька
pact - agreement - соглашение
snapped - сорвался (курить)
handle it - справиться с этим
other night - прошлая ночь
moral obligation - морально обязан
make a pass at her - наброситься на нее
sink - раковина
heads up - берегитесь
swoop in - налетать, хватать
conceivable = possible
tough - жесткий
contest - оспаривать
	no contest - никто не сомневается (не оспаривает)
dare - осмелится
pathetic - жалкий
you cannot do it to me
things are gonna work out - все наладится
there is no way to do it - нет способа сделать это
когда воййна началась, все резко изменилось. все началось со звонка друга, который сказал что война началась, мы начали прислушиваться ко взрывам


cheer you up - подбодрит тебя
keep it down
cheer you up
brag
please be kidding
I was rooting for you
negotiation
rejection
acting out - отигрывать
supposedly by accident - якобы случайно
lay off somebody - уволить или сократить
take down - снять
fill this out

what are the odds that happening - какова вероятность того, что это произойдет
what are the odds - каковы шансы
odds - шансы
sprain - растяжение
left out - опустил
I left out some details of this process, but in general threads just share process time
blow off - отменить, перенести
blow off - to decide not to do something you are expected to do, or not to meet someone you are expected to meet

can I get you anything - могу достать что угодно
admission form - анкета, форма приема

------------------------------
"in a matter of hours" is correct and usable in written English.
It is often used to describe a time frame that is relatively short compared to the amount of time that has passed. For example, "We had to pack up and move out in a matter of hours.".
------------------------------

fine line - тонкая грань
every single - каждый божий день
to be invested in - быть вовлеченным
to mess up - облажаться, провалить, испортить
moral bankrupt - аморальный
vigilance - бдительный
take someone down - свергнуть, победить
to keep in check - держать под контролем
to enhance - увеличить, улучшать
to exercise - осуществлять
vocation - призвание
I found my self ...Ving
bleak - мрачный, холодный
its getting kind of pedestrian - это становиться обыденным
to dig up dirt on someone - накопать чтото на когото

for christ sakes - ради бога
naff night - неприятная ночь
leak - утечка
wager - ставка
I'll wager - я ставлю на
concern - беспокойство
call his own shot - сделать свой собственный выбор

eternity - вечность
futile - бесполезный
follow-through - довести до конца

to direct - направлять, (в фильме - указывать)

apart from that - кроме этого

allude - намекать, упоминать, ссылаться
	he alluded to the problem but did not mentioned it - он намекнул на проблему но не стал ее называть
	he alluded to the problem without being specific - он намекнул на проблему не вдаваясь в подробности


move on to another chapter - перейти к следующей главе
remarkable - значительный, выдающийся, удивительный
remarkable achivenments - выдающиеся достижения
plumber [plumer] - водопроводчик
certainly  - определенно

to be obsessed with - быть одержимым чемто
to have a passion for - иметь страсть к чемуто
to be interested in - быть заинтересованным в
obsession - навязчивая идея
	I wasnt obsessed with car - я не был одержимым машиной
	They have an obsession with making money - Они просто помешаны на деньгах
	She has an obsession about cleanliness -  У нее есть пунктик насчет чистоты
	
on site - находящийся в месте расположения
	be on site - быть на месте
	weld on site - осуществлять монтажную сварку
	check on site - проверка на месте
	missle on site - ракета на стартовой позиции
	there is a bar, restaurant and gym on site - на территории есть бар ресторан и тренажорка
	
damp - влажный, сырой
	are yo sure you won't catch a cold? Its very damp - точно не простудишься? здесь очень сыро
	his hands were damped with sweat - его руки были влажными от пота
	my hair's still damp from the rain - мои волосы все еще влажные от дождя
	
not that - не в том смысле	
to head somewhere - аtправится кудато
persue a dream - гнатся за мечтой
more that you've been alive - ольше чем ты живешь
none of the above - ничто из этого
sensible - разумно
	a very sensible odour of garlic - очень сильный запах чеснока
	sensible error - заметная оплошнасть
	sensible clothing - удобная одежда

sinister - злой, зловещий, дурной
	sinister face - мрачное лицо, злое лицо
	sinister smile - зловещая ухмылка
	there was something sinister about him that she found disturbing - в нем было чтото зловещее, от чего ей становилось не по себе
	there was something sinister about him - в нем было чтото ужасное

basically - в целом
congrats on the family - поздравляю с семьей
to get along with - уживаться, ладить вместе
enlightened - просвещенный, хорошо информированный
ultrasound - узи
to snore - храпеть, сопеть
nap - прикемарить
power nap - нормально так прикемарить (типо в неподходящем месте)
thats about to finish - это вот вот закончится
thrilled [thrild] - взволнованный, возбужденный, заинтригованный
sights of london - достопримечательности лондона
sightseeing - осмотр достопримечательностей
	
seemingly - видимо
memorize - запоминать

go nuts - крыша поехала, сойти с ума, дуреть
	I thought I would go nuts - я думал что сойду с ума
	
as opposed to - в противоположность
	we are absolutely opposed to the idea - мы абсолтно против этой идеи
	
nothing can come between me and quality - ничего не может стоять между мной и качеством
she was wearing nothing but a towel - на ней небыло ничего кроме полотенца

attitude - отношение
apart - кроме того
broad - широкий
tolerance - толерантный, терпимый
band - группа, соединять, сязівать, набор
happen to not knowing what they are doing - случаетс что они не знаю что делают
its always a different thing - ето всегда по разному
read the room - понимать мнение или отношение людей в группе с которіми ті говоришь
lad - парнишка
close door behind you - закріваешь дверь за собой
keep it to yourself - держи єто при себе
wire - провод
to behave - вести себя хорошо
to behave courageously - вести себя мужественно
to behave abominably - вести себя отвратительно

naughty [nati] - непослушный, озорной, капризный, испорченый
make an effort - приложить усилие
	we make every effort to satisfy clients with - мы прилагаем все усилия чтобы удовлетворить клиентов
	
test your knowledge on php - проверить твои знания о пхп

urge - убеждать, сильное желание
fought - сдерживать
	he fought the urge to cry - он сдерживал сильное желание заплакать
	
intoxicated - опьяненный, одурманенный	
although [olzou] - хотя
wander -  бродить, шататся, блуждать

to be overcome with grief - быть охваченным горем

solitude - уеденение
must have been brutal - непросто там было
glue - клей
im getting cabin fever - засиделся дома, крайняя раздражительность ????????
it would not be much longer - уже скоро
what's the occassion - что за повод
trace - след
adorable - милый, восхитительный
prodigal son - блудный сын
what happens if I finish that - не возражаешь если я закончу с этим
coincedence - совпадение
buckle up - пристегнись
help me with a case - помочь в расследовании
if anything happens to this that it - если с этим чтото случиться это конец
wager - держу пари
fabulous - поразительный
might not happen to have a piece of cheese about you? -  не ли у тебя кусочка сыра с собой?
rude - грубо
this is real something - это впечатляет
paved over - заасфальтированный
take apart - разбирать на части

experience of wandering around alone in the forest and being overcome with a sense of woodland solitude - 
	
overwhelming - ошеломляющий

even when it does not seem like a reasonable thing to do - даже когда это не кажется разумно
in the 5th grade - в пятом класее
the best grades of tea are expensive - лучшие сорта чая дорогие

pull smth off - снять, стащить, стянуть
oepn book to a page thats marked - открыла книгу на отмеченной странице
carpet - ковер


got to know - узнал
but then I got to know her - но потом я узнал ее
I got to know how this story ends - я должен знать как законилась эта история

can you get it? how many of you cant get it? - вы поняли? кто из вас не понял ?
he get it - он понимает
humble - скромный
I am humbled to do it - для меня большая честь сделать это

	
to blow smth - проворонить


happy belated birthday
you turned 30 - тебе исполнилось
to give someone a bunch of shit - наехать на когото
until just now
i didnt even remember it until just nw
hilarious - уморительный
other than you - кроме тебя
to rehearse - репетировать
on good terms - в хороших отношениях

its obviously not urgent or else they would have called us straight away


aberrant behaviour - аномалное поведение
disarray - беспорядок

to apply - подавать заявление
to gain - набирать, приобретать
	to gain weight - набирать вес
	
facility - обьект, установка, возможность, предприятие
to facilitate - облегчать, способствовать
humble opinion - скромному мнению
to fall flaton your face - упасть лицом в грязь


[END]
